11111
10E01
1P001
1C0C1
11111
