1111111111111111
100000000CCCCC1
10E00000CCCCCCC1
1000000000000001
1P00000000000001
1CCCCCCCCCCCCCC1
1111111111111111
