1111111111111111
1000000000CCCCC1
10P00000CCCCCCC1
1P00000000000001
1P00000000000001
1CCCCCCCCCCCCCC1
1111111111111111
