111111111
1110E1001
10P011001
11C0010C1
111111111
