111111111
111001E01
10P011001
11C0010C1
111111111
