11111111111111111111111111
10C000C000C00000C000C10001
10C00000000000000000010001
10011111111111000000P10001
11011111111111111111110001
1CCC00000000000000CC0000E1
11111111111111111111111111
