11111111111111111111111111
10000000000000000000010001
10000000000000000000010001
10111111111111000000010001
11P11111111111111111110001
1CCC00000000000000CC0000E1
11111111111111111111111111
